**#******XX******#**
*XX*XXXX*XX*XXXX*XX*
********************
*XX*X*XXXXXXXX*X*XX*
****X****XX****X****
X*X*X XXXXXXXX X*X*X
X*X*X          X*X*X
**X*X XX----XX X*X**
*XX*  X 1234 X  *XX*
*XX*X XXXXXXXX X*XX*
**X*X          X*X**
X*X*X ******** X*X*X
X*X*X*XXXXXXXX*X*X*X
*********XX*********
*XX*XXXX*XX*XXXX*XX*
**X*******A******X**
X*X*X*XXXXXXXX*X*X*X
****X**********X****
*XX*XXXX*XX*XXXX*XX*
#********XX********#