********************
#XXX****X**X****XXX#
**X*****X**X*****X**
******XXX**XXX******
********************
**P**************P**
**P*****####*****P**
**P**************P**
**P***XX----XX***P**
**P***X 1234 X***P**
******XXXXXXXX******
********************
***XXXXXXXXXXXXXX***
******A************#
******XXXXXXXX*****#
**P***X******X***P*#
**P***X******X***P*#
**PP************PP*#
*******V*V**********
********V*V*********