XXXXXXXXXXXXXXXXXXXXXX
X********************X
X*XXXXX*X*XX*X*XXXXX*X
X*X*X*X*X*XX*X*X*X*X*X
X*X*X*X*X*XX*X*X*X*X*X
X*X*X*X********X*X*X*X
X*X*X*X*XXXXXX*X*X*X*X
X*******1************X
X*X*X*XXX----XXX*X*X*X
X*X*X*XX  234 XX*X*X*X
X*X*X*XXXXXXXXXX*X*X*X
X********************X
X*X*XX*X*X*X*X*X*X*X*X
X*X*XX*X*X*X*X*X*X*X*X
X********************X
X*X*X*XXXXXXXX*X*X*X*X
X*X********A*****X*X*X
X*X*XXXXXXXXXXXX*X*X*X
X******************X*X
X*XXXXXXXXXXXXXXXX*X*X
X*******************#X
XXXXXXXXXXXXXXXXXXXXXX