********************
#XXX****X**X****XXX#
**X*****X**X*****X**
******XXX**XXX******
********************
**P**************P**
**P*****PPPP*****P**
**P**************P**
**P***XX----XX***P**
**P***X EEEE X***P**
******XXXXXXXX******
********************
***XXXXXXXXXXXXXX***
******P*************
******XXXXXXXX******
**P***X******X***P**
**P***X******X***P**
**PP************PP**
********************
********************